'''#'
'##1##
'#111#''''###
'#111#'###444#
#22222#555447#
#22#22#4##444#
#22#22#1########
#22222#1#''#6666#
'##1##333###6#66#
''#1113537736####
''####333###6##66#
''#####1#''#66266#
''''''#1#''####66#
''''''#3#'#1#''##
''#####3##444#
'#622655574441#
'#662#####444#
''###'''''#1#
'''''''''''#