'###
#111#
#111#
#121#
#222#
#222#
#121#
'###