'###
#-S-#
#---#
#---#
#K-K#
#---#
#-G-#
'###